
WWWWWWWWWWWW 
W**********W  
W**W*****W*W
w**W*****W*E
WB*WWWWWWWWW
-
WWWWWWWWWWEW
W*******WW*W
W***W****W*W
B**********W
WWWW**WWWWWW
-
WWWWWWWWWWWW
WW*********W
B**********W
WW*********W
WWWWWWWWWWEW
-
WWWWWWWWWWBW  
W**********W   
W**WW**WW**W   
W**********E  
WWWWWWWWWWWW   
-
WWWWBWWWWWWW
WWW***WWW**E 
WW******WW*W
WW*W*W*****W
WWWWWWW*WWWW 
-
WWWWWWWWWWBW
W**********W
W*WWWWWWWWWW
W**********W
WWWWWWWWWWEW
-