
WWWWWWWWWWWW 
W**********W  
W**W*****W*W 
***W*****W*E 
WB*WWWWWWWWW 
-
WWWWWWWWWWEW
W*******WW*W
W***W****W*W
B**********W
WWWW**WWWWWW
-
WWWWWWWWWWww
WW*W*W*W*W*W
B**********W
WW*W*W*W*W*W
WWWWWWWWWWEW
-
WWWWWWWWWWBW  
W**********W   
W**WW**WW**W   
W**********E  
WWWWWWWWWWWW   
-
WWWWBWWWWWWW
WWW***WWW**E 
WW******WW*W
WW*W*W*****W
WWWWWWW*WWWW 
-
WWWWWWWWWWBW
W**********W
W*WWWWWWWWWW
W**********W
WWWWWWWWWWEW
-