
 WWWWWWWWWWWW 
 W**********W  
WW**W****W**WWW
*B*W****W**E***
WWWWWWWWWWWWWWW
-
 WWWWWWWWWWwW
 W*******WW*W
WW***W****W*WWW
*B***W******E**
WWWWWWWWWWWWWWW
-
 WWWWWWWWWWWW
 WW*********W
*B**********W
WWW*********W
 WWWWWWWWWWEW
-
WWWWWWWWWWBW  
W**********W   
W**WW**WW**W   
W**********E  
WWWWWWWWWWWW   
-
WWWWBWWWWWWW
WWW***WWW**E 
WW******WW*W
WW*W*W*****W
WWWWWWW*WWWW 
-
WWWWWWWWWWBW
W**********W
W*WWWWWWWWWW
W**********W
WWWWWWWWWWEW
-